############
#OO##O#OOOO#
##OOOO#O##O#
#OO##O#O#OO#
#O###OOO#O##
#OOOO####OE#
####O#OOO#O#
#OOOOOO#O#O#
#O##O##OO#O#
#OO#M##O##O#
##O####OOOO#
############