############
#OO##O#OOOO#
##OOOO#O##O#
#OO##O#O#OO#
#O###OOO#O##
#OOOO####OE#
####O#######
####O#######
####O#######
####M#######
############